0020011111
0020000111
0020000001
0022000000
0000200110
0000020110
0000022000
0000022222
0000222222
0022222222