002001111111000002222
002000011111000022222
002000000100000022222
002200000000000000222
000020011000022200022
000002011011111220000
000002200011122200000
000002222211112200000
000022222222200000000
002222222220000000000