1111111111
1020000001
1020000001
1022000001
1000200001
1000020001
1000022001
1000022221
1000002221
1222222221