110000011
111001111
111001111
111000011
111100011
111110011
111110011
110000011
110001111
110011111
110011111
111111111